    ####### 
    #.....# 
    #.###.# 
    #..@#.# 
    #@#.@.# 
    ####### 
